Score:            Lives:    
############################
#....#.......##.......#....#
#.####.#####.##.#####.####.#
#.####.#####.##.#####.####.#
#....#................#....#
#.####.##.########.##.####.#
#......##....##....##......#
######.##### ## #####.######
######.##          ##.######
######.## ###--### ##.######
######.## #      # ##.######
     ...  #      #   ...    
######.## #      # ##.######
######.## ######## ##.######
######.##          ##.######
######.## ######## ##.######
#............##............#
#.####.#####.##.#####.####.#
#...##................##...#
###.##.##.########.##.##.###
#......##....##....##......#
#.##########.##.##########.#
#..........................#
############################